1111111111
1.1.....11
1.1..11.11
1.11.11.11
1.11.11.11
1.......11
111.11.111
111....111
111...1111
1111111111
